111111111
10000C001
10P000001
10C000E01
100000001
111111111