1111111111
1P000000E1
1011001101
1010C00101
1000000001
1000110001
10000F0001
1010000101
1C11001101
10000C0001
1111111111